1511115111
1131113111
1111315111
1161111311
2221211111
1111222222
1164111311
1141171111
1113111311
1914118111